der Vater	father	n
der Freund	friend	n
der Hahn	rooster	n
der Stier	bull	n
der Gott	god	n
der Künstler	artist	n
der Arbeiter	worker	n
der Wissenschaftler	scientist	n
der Schriftsteller	writer	n
der Computer	computer	n
der Kugelschreiber	pen	n
der Montag	Monday	n
der Mittwoch	Wednesday	n
der Oktober	October	n
der Dezember	December	n
der Winter	winter	n
der Sommer	summer	n
der König	king	n
der Teppich	carpet/rug	n
der Sperling	sparrow	n
der Palast	palace	n
der Sozialismus	socialism	n
der Norden	north	n
der Süden	south	n
der Osten	east	n
der Westen	west	n
die Mutter	mother	n
die Freundin	friend	n
die Henne	hen	n
die Kuh	cow	n
die Göttin	goddess	n
die Künstlerin	artist	n
die Bäackerie	bakery	n
die Industrie	industry	n
die Musik	music	n
die Architektin	architect	n
die Version	version	n
die Gesundheit	health	n
die Gesellschaft	society	n
die Universität	university	n
die Hoffnung	hope	n
die Literatur	literature	n
das Buch	book	n
das Büchlein	small book	n
das Teil	part	n
das Teilchen	particle	n
das Männlein	little man	n
das Tischchen	little table	n
das Auto	auto	n
das Radio	radio	n
das Embargo	embargo	n
das Video	video	n
das Kommen	coming	n
das Gehen	going	n
das Wissen	knowledge	n
das Lernen	learning	n
das Denken	thinking	n
das Sein	being	n
das Studium	study	n
das Universum	universe	n
das Evangelium	gospel	n
das Visum	visa	n
