aus/stellen	to exhibit	v
die Vielfalt	diversity	n	-
die Sammlung	collection	n	-en
die Schenkung	gift, donation	n	-en
der Druck	print	n	-e
#auf mehr als	to more than
die Zeichnung	drawing	n	-en
die Rettung	rescue	n	-en
gefährden	to endanger	v
bedrohen	to threaten	v
der Erfolg	success	n	-e
gedeihen (gedieh, ist gediehen)	to flourish	v (sp, pp)
der Nährstoff	nutrient	n	-e
ein/dringen (drang…ein, ist eingedrungen)	to penetrate	v	irreg (sp, pp)
feste	fixed	adj
ab/fassen	to write, compose	v
auf/nehmen (nahm…auf, aufgenommen; nimmt…auf)	to adopt, take up	v	irreg (sp, pp; 3p)
vereinigen	to combine, unify
die Behauptung	assertion, statement	n	-en
egreifend	gripping	adj
mehrfach	multiple	adj
ununterbrochen	uninterrupted	adj
beschleunigen	to accelerate	v
#das Wachstum	growth	n
zusammen/drängen	to compress	v
wieder/geben (gab…wieder, wiedergegeben; gibt…wieder)	to reproduce	v	irreg (sp, pp; 3p)
aufrecht/erhalten (erhielt…aufrecht, aufrechterhalten; erhält…aufrecht)	to maintain	v	irreg (sp, pp; 3p)
der Friede	peace	n	n-noun
an/dauern	to last, continue	v
die Übereinstimmung	agreement	n	-en
beteiligt	involved	adj
das Kriegführen	waging of war	n
dreierlei	three kinds of	adj
die Ding	thing	n	-e
#Es-Dur	E-flat major
die Bewunderung	admiration	n
genießen (genoss, genossen)	to enjoy	v	irreg (sp, pp)
die Unruhen	disturbances	n
brennbar	combustible	adj
der Wasserstoff	hydrogen	n
füllen	to fill	v
gehen (ging, gegangen; geht)	to go	v	irreg (sp, pp; 3p)
#im Wappen	on the coat of arms
der König	king	n	-e
die Krone	crown	n	-n
überhaupt	altogether	adv
#leider nur	unfortunately only
#Zoologischer Garten	(western Berlin) zoo
#Tierpark	(eastern Berlin) zoo
au/sterben (starb…aus, ist…ausgestorben; stirbt…aus)	to die out, become extinct	v	irreg (sp, pp; 3p)
#aus diesem Grund	for this reason
#besonders	especially	adv
hauptsächlich	mainly, predominantly	adv
massig	big, heavy	adj
#gehören zu	to belong to
das Raubtier	predatory animal	n	-e
der Allesfresser	omnivore	n	-
der Sohlengänger	plantigrade animal	n	-
#zum großen Teil	for the most part, to a large extent
das Benehmen	behavior	n
#geprägt	characterized
#sich paaren	to mate
männlich	male	adj
weiblich	female	adj
die Paarung	mating	n
schwinden (schwand, gewschwunden)	to vanish	v	irreg (sp, pp)
verbringen (verbrachte, verbracht)	to spend	v	strong (sp, pp)
getrennt	separated	adj
riesigen	giant	adj
#werden geboren	are born
der Säugling	infant, suckling	n	-e
der Wurf	brood, litter	n	-e
wiegen	to weigh	v
#werden gesäugt	are suckled
unterrichten	to teach	v
klettern	to climb	v
pflücken	to pick	v
beschützen	to protect	v
ständig	constant	adj
der Ausschau	watch out	n
der Einzelgänger	loner	n	-
töten	to kill	v
gefährlich	dangerous	adj
