der Bewohner	inhabitant	n	-
das Vielfältigkeit	diversity	n	-en
#die Suche	search	n	
der Wohnsitz	abode, domicile	n	-e
#ziehen durch (zog, ist…gezogen)	to roam through
die Eiszeit	ice age, glacial period	n	-en
#das Gebiet	region, area	n	-e
verdrängen	to push out	v
einheimisch	native	adj
gründen	to found	v
#später	later	adv
#die Donau	Danube	n
vor/dringen (drang…vor, ist vorgedrungen)	to advance, penetrate	v	irreg (sp, pp)
die Festung	fort, fortress	n	-en
sichern	to secure	v
das Ufer	bank	n	-
der Weg	way, route	n	-e
#der Zimber	Cimbrian	n	-n
die Schlacht	battle	n	-en
zusammen/stoßen (stieß…zusammen, ist zusammengestoßen; stößt…zusammen)	to clash, collide	v	irreg (sp, pp; 3p)
#einer der erstern	one of the first
überqueren	to cross	v
#der Markomanne	Germanic tribe	n	-n
#das Venetien	Venetia	n
zurück/treiben (trieb…zurück, zurückgetrieben)	to drive back	v
schließlich	finally	adv
die Völkerwanderung	mass migration	n	-en
#der Stamm	tribe	n	-¨e
ein/fallen (feil…ein, ist eingefallen; fällt…ein)	to invade	v	irreg (sp, pp; 3p)
der Gote	goth	n	n-noun
#der Langobard	Lombard	n	-n
#besetzen	to occupy	v
sogar	even	adv
#das Alpental	Alpine valley	n	-¨er
die Einwanderung	immigration	n	-en
die Besiedlung	settlement	n	-en
fördern	to further, advance	v
bedeutend	important	adj
regieren	to rule, govern	v
die Kaiserkrone	imperial city	n	-n
der Zusammenbruch	collapse	n	-¨e
#bestehen aus (bestand, bestanden)	to be made up of
#dieselben	the same	adj	pl
ein/marschieren	to invade	v
die Vollziehung	execution	n
der Anschluss	annexation	n
die Wiedervereinigung	reunification	n
teilen	to divide	v
die Alliierten	the allies	n	pl.
die Besatzung	occupation	n
der Flüchtling	refugee	n	-e
auf/nehmen (nahm…auf, aufgenommen; nimmt…auf)	to take in, absorb	v
#zählen	to count	v
davon	of them	adv
sogenannten	so-called	adj
#bedeutend	important	adj
die Zusammensetzung	composition	n	-en
die Herkunft	origins	n	-¨e
ein/ziehen (zog…ein, ist eingezogen)	to enter, move in	v
#einige	some, a few	adj
auf/schlagen (schlug…auf, aufgeschlagen; schlägt…auf)	to set up, take up	v	irreg (sp, pp; 3p)
#stolz sein auf	to be proud of
die Spannung	tension	n	-en
#Innen- und Außenpolitik	domestic and foreign policy
entstehen (enstand, enstanden)	to develop, come about	v	irreg (sp, pp)
das Mitglied	member	n	-er
zusamen/arbeiten	to cooperate	v
der Friede	peace	n	n-noun
der Fortschritt	progress	n	-e
