äußerst	very, extremely	adj
besonders	(e)specially, particularly	adj
besser	better	adj
dagegen	on the other hand, against it	adv
doch	however, indeed, yet	adv
durchschnittlich	average, on the average	adv
erfolgreich	successful	adj
der Fall	case, situation	n	-¨e
#auf jeden Fall	in any case
#in diesem Fall(e)	in this case
geeignet	suited, suitable	adj
hart	hard	adj
die Höhe	height, elevation	n	-n
immer	always	adv
#immer reicher	richer and richer
#immer wieder	again and again
kennzeichnen	to characterize, to typify	v
lang	long	adj
#drei Jahre lang	for three years
langsam	slow	adj
der Lauf	course	n	-¨e
#im Laufe	in the course (of)
liegen	to lie, be lying down	v	irreg (sp, pp)
die Linie	line	n	-n
#in erster Linie	primarily, in the first place
das Meer	ocean, sea	n	-e
die Nähe	vicinity, nearness	n
in der Nähe	near
niedrig	low	adj
reich	rich, abundant	adj
tief	deep, low	adj
#u.a. (unter anderem, anderen)	among other things, among others
um mehr als	by more than
verbinden (verband, verbunden)	to connect, combine, unite	v	irreg (sp, pp)
vor/kommen (kam…vor, ist vorgekommen)	to occur, happen, seem	v	irreg (sp, pp)
das Wachstum	growth	n
zahlreich	numerous	adj
zu/nehmen (nahm…zuk, zugenommen; nimmt…zu)	to increase, grow	v	irreg [compound] (sp, pp; 3p)
