an/geben (gab…an, angegeben; gibt…an)	to state, cite	v	irreg (sp, pp; 3p)
voraus/setzen	to assume, presuppose	v
das Futur	future tense (grammatical)	n
der Erzieher	educator, teacher	n	-
#die Anwendung	application	n	-en
das Ziel	goal	n	-e
das Betragen	behavior	n
die Folge	consequence	n	-n
inzwischen	in the meantime, meanwhile
das Glashaus	greenhouse	n	-¨er
ungeheuer	huge, colossal, enormous
der Abfall	garbage	n	-¨e
der saurer Regen	acid rain	n
das Loch	hole	n	-¨er
die Schlange	snake	n	-n
das Weib	woman	n	-er
böse	evil	adj
angstrengend	strenuous	adj
der Muskel	muscle	n	-n
der Leser	reader	n	-
#laut einem Bericht	according to a report
das Bundesverkehrsamt	federal traffic department	n
der Unfall	accident	n	-¨e
demnächst	shortly, soon	adj adv
sicher	safe	adj
im Folgenden	in the following (text)
#statt/finden (fand…statt, stattgefunden)	to take place	v	irreg (sp, pp)
der Großraum	metropolitan area	n	-¨e
die Prognose	forecast	n	-n
voraussichtichlich	presumably, probably	adv
umfassen	to include, comprise	v
der Druck	pressure	n	-¨e
#aus/üben	to exert	v
immer zahlreicher werdend	continuously growing
#unglaublich	unbelievable	adj
vergangen	last, past, elapsed	adj
die Belastung	burden, stress	n	-en
#schwierig	difficult	adj
auf/weisen (wies…auf, aufgewiesen)	to show, have	v	irreg (sp, pp)
fest/stellen	to determine, ascertain	v
verbrauchen	to consume	v
das Holz	wood, timber	n	-¨er
die Nahrungsmittel	food	n	pl.
die Menge	mass	n	-n
die Landwirtschaft	agriculture	n	-en
die Bodenbearbeitung	cultivation of the soil	n	-en
die Bewässerung	irrigation	n	-en
krankheitsresistent	disease-resistant	adj
die Züchtung	strain of plants, growing	n	-en
das Wunder	miracle, wonder	n	-
vollbringen (vollbrachte, vollbracht)	to perform, accomplish	v	irreg (sp, pp)
möglich…einzuführen	possible to introduce
notwendig	necessary	adj
die Ausfuhr	export	n	-en
das Erzeugnis	product	n	-se
der Anstieg	rise	n	-e
Schritt halten (hielt, gehalten; hält)	to keep pace	v	irreg (sp, pp; 3p)
können (konnte, gekonnt; kann)	to be able to	v	irreg (sp, pp; 3p)
