ab/hängen von (hing…ab, abgehangen)	to be dependent upon	v	irreg (sp, pp)
ab/nehmen (nahm…ab, abgenommen; nimmt…ab)	to decrease, take off	v	irreg (sp, pp; 3p)
an/kommen (kam…an, ist angekommen)	to arrive	v	irreg (sp, pp)
beenden	to finish, complete	v
die Bevölkerung	population, inhabitants (pl.)	n	-en
doppelt	double, twice	adv adj
die Einwohnerzahl	(total) population	n
das Entwicklungsland	developing country	n	-¨er
das Erlebnis	experience	n	-se
die Ernährung	feeding, food, nourishment	n
gewinnen (gewann, gewonnen)	to win, gain	v	irreg (sp, pp)
hauptsächlich	main(ly), chief	adj adv
das Kapitel	chapter	n	-
lernen	to learn, to study (for a test)	v
die Milliarde	billion	n	-n
die Mitteilung	report, communication	n	-en
nützlich	useful	adj
das Papier	paper, document (not: newspaper, term paper)	n	-e
die Prüfung	test, examination	n	-en
die Quelle	source, spring	n	-n
die Regel	rule	n	-n
reisen	to travel	v
#rund	round; about	adj adv
selber	-self
er selber	he himself
selbst	-self; even
sogar	even	adv
das Stück	piece	n	-e
studieren	to study (a subject at the university)	v
usw. (und so weiter)	etc. (and so forth)
wohl	well, perhaps, probably, indeed, no doubt	adv
die Zahl	number, figure	n	-en
der Zuwachs	increase, growth, increment	n
