entstehen (entstand, ist enstanden)	to come into being, emerge	v	irreg (sp, pp)
die Hochschule	university, institution of higher learning	n	-n
knapp	just barely	adv
sich bekennen (bekannte, bekannt)	to profess	v	irreg (sp, pp)
die Konfession	denomination, religion	n	-en
#unter	among	prep
der Widerstand	resistance	n	-¨e
die Geistliche	clergy	n	pl
verwandelt	transformed, metamorphosed	adj
riesig	gigantic	adj
das Ungeziefer	vermin, pestiferous insect	n	-
sich kümmern um	to mind, worry about	v
der Nachbar	neighbor	n	-n
überhaupt	generally, really, at all	adv
die Bedingung	condition	n	-en
mit sich bringen (brachte, gebracht)	to entail	v	irrege (sp, pp)
die Literaturauswahl	choice of references, bibliography	n
sich konzentrieren auf	to concentrate on	v
#gemäß	according to, consistent with	prep	+dat
die Bajuwaren	Bavarians	n	pl
#Bayern	Bavaria
die Zwergvölker	pygmies	n	pl
sich interessieren für	to be interested in	v
#Hesse	Hessian	n	-n n-noun
der Söldner	mercenary	n	-
#die Bezeichnung	term, designation	n	-en
ungenau	inaccurate	adj
hegen	to cultivate	v
die Voreingenommenheit	prejudice	n
verewigen	to perpetuate	v
der Dienst	service	n	-e
die Geldsucht	avarice	n
das Opfer	victim, sacrifice	n	-
zum Opfer fallen (fiel, ist gefallen; fallt)	to fall victim to
der Landesvater	"father of the country", ruler	n	-¨
höchstbietend	highest bidding	adj
der Handel	trade, traffic	n
unterstellen	to place under	v
bis auf	to, up to	prep	+dat
auf dem Schlachtfeld fallen (fiel, ist gefallen; fällt) to die on the battlefield
der Kriegsgefangene	prisoner of war (m or f, here m)	n	-n
