der Abschnitt	chapter, section	n	-e
sich ändern	to change	v
sich an/siedeln	to settle	v
außerrordentlich	extraordinary	adj
sich befassen mit	to deal with, to concern oneself with	v
sich befinden (befand, befunden)	to be located; to be, feel; to find oneself	v	irreg (sp, pp)
sich beschränken auf	to limit oneself to, be limited to	v
der Bürger	citizen (m)	n	-
die Bürgerin	citizen (f)	n	-nen
dunkel	dark	adj
der Durchschnitt	average, cross-section	n	-e
eingehend	thoroughly, in detail
sich entwickeln	to develop, evolve	v
erinnern	to remind
sich erinnern	to remember
der Fortschritt	progress	n	-e
das Gesicht	face	n	-er
der Held	hero	n	-en n-noun
leider	unfortunately	adv
der Nachteil	disadvantage	n	-e
sich nieder/lassen (ließ…nieder, niedergelassen; lässt…nieder)	to settle down, establish oneself	v	irreg (sp, pp; 3p)
plötzlich	suddenly	adv
schrecklich	frightful, terrible, dreadful, awful, horrible, hideous	adj
der Titel	title	n	-
verletzen	to injure	v
sich verletzen	to get hurt, injure oneself	v
sich vermehren	to multiply	v
versprechen (versprach, versprochen; verspricht)	to promise	v	irreg (sp, pp; 3p)
wachsen (wuchs, ist gewachsen; wächst)	to grow	v	irreg (sp, pp; 3p)
