bereiten	to cause, prepare	v
der Vertrag	treaty	n	-¨e
ab/treten (trat…ab, ist abgetreten; tritt…ab)	to surrender, cede	v	irreg (sp, pp; 3p)
gedeihen (gedieh, ist gediehen)	to thrive	v	irreg (sp, pp)
regelmäßig	regular, regularly	adv adj
bewässern	to water (a plant)	v
beleuchten	to view, illuminate, elucidate	v
der Konkurrenzkampf	competition, competitive struggle	n	-¨e
die Senkung	decrease, lowering	n	-en
erreichen	to achieve, attain	v
auf Kosten	at the expense
ein/schalten	to switch on	v
aus/schalten	to switch off	v
beliebig	as desired, arbitrarily	adv
der Strom	the stream, current	n	-¨e
die Fundstelle	archaeological site, dig	n	-n
vorgeschichtlich	prehistoric	adj
die Sendung	broadcast, show	n	-en
das Fernsehprogramm	television station	n	-e
empfangen (empfing, empfangen; empfängt)	to receive	v	irreg (sp, pp; 3p)
die Erinnerung	memory	n	-en
erhalten (erhielt, erhalten; erhält)	to retain, obtain	v	irreg (sp, pp; 3p)
vollständig	completely	adv
löschen	to wipe out, extinguish	v
#der Kollege	colleague	n	-n n-noun
das Ding an sich	thing in itself, i.e. independent of human perception	n
#unsichtbar	invisible, imperceptible	adj
wahr/nehmen (nahm…wahr, wahrgenommen; nimmt…wahr)	to perceive	v	irrge (sp, pp; 3p)
die Aufklärung	enlightenment	n
zugleich	simultaneously	adv
der Überwinder	conqueror	n	-
sich bemühen um	to concern oneself with	v
hoffen	to hope	v
auf/stellen	to formulate, advance	v
die Vernunft	reason	n
die Erkenntnis	knowledge, perception	n
an/sprechen (sprach…an, angesprochen; spricht…an)	to address	v (sp, pp; 3p)
erfordern	to require, call for, need	v
#die Freiheit	freedom	n	-en
unschädlich	unharmful	adj
was nur…heißen mag	whatever one wants to call
nämlich	namely, that is
öffentlich	public	adj
der Gebrauch	use	n
räsonieren	to reason, be rational	v
rufen (rief)	to shout, call out	v	irreg (sp)
exerzieren	to drill	v
der Finanzrat	finance minister	n	-¨e
geistlich	spiritual	adj
#der Herr	lord, here Friedrich II
worüber	about which, about what
gehorchen	to obey	v
die Einschränkung	limitation	n	-en
hinderlich	hindering, obstructive	adj
beförderlich	favorable, conducive	adj
gar	indeed	adv
jederzeit	at all times
der allein	that alone, only, that (one)
zustande bringen (brachte, gebracht)	to bring about	v	irreg (sp, pp)
derselben	of the same
öfters	often	adv
ein/schränken	to limit	v
#der Fortschritt	progress	n
sonderlich	particularly	adv
#wenn	whenever, if
