der Lauf	course, path	n	-¨e
deuten	to interpret, construe	v
wählen	to select, choose	v
(sich) verständigen	to make oneself understood, to communicate	v
fließend	fluent	adj
das Gebot	commandment	n	-e
lauten	to say, read	v
missbrauchen	to misuse, speak in vain	v
der Hüter	keeper, protecter	n	-
die Maus	mouse	n	-¨e
bei uns	at home, in our country
die Dunkelheit	darkness	n
der Unfall	accident	-¨e
der Schweiß	sweat	n
das Angesieht	face, brow	n
der Lebensunterhalt	livelihood	n
verdienen	to earn	v
der Frontkämpfer	combat soldier	n	-
jedoch	however
die Kugel	bullet	n	-n
pfeiffen (pfiff, gepfiffen)	to whistle	v	irreg (sp, pp)
die Züchtung	cultivation, breeding	n	-en
die Sorte	variety, kind	n	-n
der Sauier	saurian, dinosaur	n
#Patagonien	(South American region) Patagonia
im Rahmen	in the framework
die Ausgrabung	excavation	n	-en
die Überreste	remains	n
fleischfressend	carnivorous	adj
#der je gelebt hat	that ever lived
die Urzeitriese	prehistoric giant	n	-n
der Fund	discovery, find	n	-e
hin/weisen auf	to point to, indicate	v
der Rudel	herd, pack	n	-
der Bein	leg	n	-e
die Ähnlichkeit	similarity	n	-en
schmal	narrow	adj
der Schädel	skull	n	-
rasiermesserscharf	razor-sharp	adj
der Zahn	tooth	n	-¨e
das Kralle	claw	n	-n
der Urzeitjäger	prehistoric hunter	n	-
die Beute	prey	n
chirurgisch	surgical	adj
zerlegen	to dissect	v
der Nussknacker	nutcracker	n	-
zerdrücken	to crush	v
das Opfer	victim	n	-
das Maul	mouth, muzzle	n	-
widerlich	revolting, repulsive	adj
furchterregend	frightening, horrific	adj
bisher	so far, hitherto
um knapp	by about
verwandt	relative	adj
