unter/gehen (ging…unter, ist untergegangen)	to set, sink	v	irreg (sp, pp)
unterschiedlich	different	adj
uvertreten (vertrat, vertraten; vertritt)	to advocate, defend	v	irreg (sp, pp; 3p)
die Einigung	agreement	n	-en
die Versicherung	insurance	n	-en
klären	to clarify	v
die Überquerung	crossing	n	-en
die Biene	bee	n	-n
die Blüte	blossom	n	-n
der Stock	hive	n	-¨e
der Tanz	dance	n	-¨e
eigenartige	peculiar	adj
der Goldschmied	goldsmith	n	-e
der Palast	palace	n	-¨e
bzw. (beziehungsweise)	either/or; respectively
die Handlung	action, plot	n	-en
die Entfremdung	alienation	n	-en
der Anhänger	adherent, follower	n	-
der Maßstab	criterion, measure	n	-¨e
erheben (erhob, erhoben)	to raise, elevate	v	irreg (sp, pp)
die Gärung	fermentation	n
die Lebenstätigkeit	activity	n	-en
der Pilz	fungus, mushroom	n	-e
verhindern	to prevent	v
verlegen	to transfer, shift	v
die Verwaltung	administration	n
das Luftschiff	airship, Zeppelin	n	-e
die Flotte	fleet	n	-n
vor/schlagen (schlug…vor, vorgeschlagen; schlägt…vor)	to suggest, propose	v	irreg (sp, pp; 3p)
schicken	to send	v
die Leitung	direction	n	-en
starten	to take off	v
aus/brechen (brach…aus, ist ausgebrochen; bricht…aus)	to start, break out	v	irreg (sp, pp; 3p)
die Marine	navy	n
das Heer	army	n	-e
übernehmen (übernahm, übernommen; übernimmt)	to take over	v	irreg (sp, pp; 3p)
#die Aufklärung	reconnaissance	n	-en
der Bombenabwurf	bombing	n	-¨e
ein/setzen	to engage, use	v
der Angriff	attack	n	-e
erregen	to arouse, cause	v
der Schreck(en)	alarm, fright	n	-
die Abwehr	defense	n
die Granate	shell, grenade	n	-n
erreichen	attain, reach	v
die Flugabwehr	air defense	n
an/greifen (griff…an, angegriffen)	to attack	v	irreg (sp, pp)
das Jagdflugzeug	fighter plane	n	-e
brennbar	combustible	adj
der Wasserstoff	hydrogen	n
genügen	to suffice	v
um…zu verwandeln	to transform	v
erleiden (erlitt, erlitten)	to suffer	v	irreg (sp, pp)
die Mannschaft	crew	n	-en
das Himmelfahrtskommando	suicide mission	n	-s
der Wert	value, worth	n	-e
ein/dringen (drang…ein, ist eingedrungen)	to penetrate	v	irreg (sp, pp)
die Streitkräfte	armed forces	n	pl.
die Entscheidungsschlacht	decisive battle	n	-en
