im Gegensatz zu	in contrast to
das Pferd	horse	n	-e
her/stellen	to produce	v
fest/stellen	to determine	v
anfällig	susceptible	adj
verwenden	to use, employ	v
der Vogel	bird	n	-¨
das Straußenei	ostrich egg	n	-er
das Huhn	chicken	n	-¨er
schmackhaft	tasty	adj
#das Saarland	federal state in southwest Germany
benachbart	neighboring, adjacent	adj
entwerfen (entwarf, entworfen; entwirft)	to design	v	irreg (sp, pp; 3p)
besichtigen	to visit, view	v
beschäftigen	to employ, occupy	v
sich beschäftigen mit	to deal with, engage in	v
feiern	to celebrate	v
der Wandel	change, transformation	n
das Virtuosentum	virtuosity	n
entscheidend	decisive	adj
verehren	to worship	v
die Kaste	cast	n	-n
die Sünde	sin	n	-n
büßen	to atone
das Datum	date	n	-um/-en
die Umwälzung	revolution, upheaval	n	-en
das Ereignis	event	n	-se
verbunden sein	to be coupled with	v
die Trivialliteratur	pulp fiction	n
die Armut	poverty	n
beliebt	popular	adj
meistgelesen	most frequently read	adj
die Gesamtauflage	total circulation, total number of books in print	n
überschreiten (überschritt, überschritten)	to exceed	v	irreg (sp, pp)
vor/liegen (lag…vor, vorgelegen)	to be available	v	irreg (sp, pp)
eng	close	adj
gegenseitig	each other, one another
malen	to paint	v
in diesem Sinne	in this spirit
sich in Not befinden (befand, befunden)	to be in danger	v	irreg (sp, pp)
die Haut	skin	n
unzählig	countless	adj
wahr	true	adj
letztendlich	in the final analysis
führen nach	to lead to, to take to	v
der Herbst	autumn	n	-e
hauptsächlich	mainly, primarily	adv
#damals	at that time
