beginnen	begin	v	-en
bringen	bring	v	-en
enden	end	v	-en
finden	find	v	-en
geben	give	v	-en
gewinnen	win	v	-en
hÃ¤ngen	hang	v	-en
helfen	help	v	-en
hÃ¶ren	hear	v	-en
kosten	cost	v	-en
landen	land	v	-en
lernen	learn	v	-en
salzen	salt	v	-en
scheinen	seem	v	-en
schwimmen	swim	v	-en
senden	send	v	-en
setzen	set	v	-en
singen	sing	v	-en
sinken	sink	v	-en
sitzen	sit	v	-en
springen	spring	v	-en
starten	start	v	-en
stinken	stink	v	-en
stoppen	stop	v	-en
trinken	drink	v	-en
wandern	wander	v	-en
waschen	wash	v	-en
analysieren	analyze	v	-ieren
argumentieren	argue	v	-ieren
debattieren	debate	v	-ieren
demonstrieren	demonstrate	v	-ieren
dokumentieren	document	v	-ieren
dominieren	dominate	v	-ieren
evakuieren	evacuate	v	-ieren
evaluieren	evaluate	v	-ieren
fotografieren	photograph	v	-ieren
funktionieren	function	v	-ieren
informieren	inform	v	-ieren
investieren	invest	v	-ieren
kombinieren	combine	v	-ieren
kommentieren	comment	v	-ieren
komplimentieren	compliment	v	-ieren
komplizieren	complicate	v	-ieren
nominieren	nominate	v	-ieren
protestieren	protest	v	-ieren
qualifizieren	qualify	v	-ieren
quantifizieren	quantify	v	-ieren
rationalisieren	rationalize	v	-ieren
reparieren	repair	v	-ieren
rehabilitieren	rehabilitate	v	-ieren
studieren	study	v	-ieren
trainieren	train	v	-ieren

