sich erlauben	to afford, permit oneself	v
schweifen	to roam	v
das Glück	good fortunate, happiness	n
ergreifen (ergriff, ergriffen)	to take hold of, seize	v	irreg (sp, pp)
anständige	decent	adj
fast	nearly	adv
leiden (an) (litt, gelitten)	suffer (from)	v	irreg (sp, pp)
sich sehnen (nach)	to long (for)	v
dagegen	on the other hand	prep
im Folgenden	in the following (text)
undurchsichtig	opaque	adj
durchdringen (durchdrang, durchdrungen)	to penetrate	v	irreg (sp, pp)
unter	among	prep	+dat
der Einbruch	invasion	n	-¨e
verteidigen	to defend	v
auf/teilen	to divide	v
die Lehrfreiheit	freedom of instruction	n
dazu	for (the purpose of)
zwingen (zwang, gezwungen)	to force, coerce	v	irreg (sp, pp)
die Verfassung	constitution	n	-en
an/greifen (griff…an, angegriffen)	to attack	v	irreg (sp, pp)
die Maxime	maxim, principle	n	-n
die Gesetzgebung	legislation (law)	n	-en
gelten (galt, gegolten; gilt)	to be considered, be valid	v	irreg (sp, pp; 3p)
könnte	could (subjunctive)
sich beherrschen	to control oneself, restrain oneself	v
die Selbstüberwindung	self-control	n
der Hörer	listener, student attending a lecture	n	-
lachen über	to laugh at
erleben	to experience	v
die Blüte	flowering, blossoming	n	-n
es gelang einer Gruppe	a group succeeded
veraltet	outdated	adj
das Lustspiel	comedy	n	-e
ersetzen	to replace	v
öffentlich	public	adj
die Förderung	sponsorship, grant	n	-en
erwähnen	to mention	v
die Unterstützung	support	n	-en
bemerkenswert	noteworthy	adj
drehen	to make, shoot (a film)	v
dabei	in the process
erstaunlich	amazing	adj
Vielfalt an	variety of
der Abschied	departure, farewell	n	-e
gekonnt	skillfully	adv
eindeutig	clear	adj
plötzlich	suddenly	adv
die Mühe	trouble, effort	n	-n
Anschluss finden (fand, gefunden)	to catch up	v	irreg (sp, pp)
in Schwung kommen (kam, ist gekommen)	to get going	v	irreg (sp, pp)
der Spielfilm	feature film	n	-e
gut	easily	adv
gehören	to belong	v
die Ehe	marriage	n	-n
der Außenseiter	outsider	n	-
die Fernsehserie	television series	n	-n
