an/deuten	to indicate, mention briefly	v
anstatt, statt	instead (of)
bemerken	to notice	v
beweisen (bewies, bewiesen)	to prove	v	irreg (sp, pp)
bitte	please
ehren	to honor	v
ein/gehen	(ging…ein,ist eingegegangen)	to go into, enter	v	irreg (sp, pp)
die Einzelheit	detail	n	-en
der Filmemacher	filmmaker, film director (m)	n	-
die Filmemacherin	filmmaker, film director (f)	n	-nen
fort/fahren (fuhr…fort, ist fortgefahren; fährt…fort)	to continue	v	irreg (sp, pp; 3p)
gefallen (gefiel, gefallen)	to please, be pleasing	v	irreg (sp, pp)
es gefällt mir	I like it, it is pleasing to me
gelingen (gelang, ist gelungen)	to succeed	v	irreg (sp, pp)
es gelingt ihm	he is successful
glauben (an)	to believe (in)	v
halten (hielt, gehalten; hält)	to hold, stop	v	irreg (sp, pp; 3p)
#halten für	to consider
hoffen (auf)	to hope (for)	v
imstande sein	to be able	v
jederzeit	any time, at all times, always	adv
das Kino	cinema, movie theater	n	-s
die Menschheit	mankind, humanity	n
näher	more closely, in greater detail	adv
der Satz	sentence, theorem, movement (music)	n	-¨e
die Sicherheit	security, safety	n
sichern	to protect	v
der Sohn	son	n	-¨e
unter	under, among	prep	+dat
versuchen	to try	v
warten (auf)	to wait (for)	v
der Wille	will	n	n-noun
das Ziel	goal, aim	n	-e
zugleich	also, at the same time
