laufend	continuously	adj
bahnbrechend	pioneering, revolutionary	adj
veröffentlichen	to publish	v
die Mitteilung	communication, report	n	-en
die Zeitschrift	magazine, journal	n	-en
der Beitrag	contribution, article	n	-¨e
das Erziehungswesen	educational system	n
unerlässlich	indispensable	adj
umfangreich	extensive, voluminous	adj
vorzüglich	excellent	adj
ausgestattet mit	replete with, furnished with	v
die Abhandlung	treatment	n
uraufgeführt	premiered	adj
entwerfen (entwarf, entworfen; entwirft)	to design, plan	v	irreg (sp, pp; 3p)
zum Ausdruck bringen (brachte, gebracht)	to express (to bring to expression)	v	irreg (sp, pp)
körperlich	physical	adj
aus/drücken	to express	v
sich entfremden	to alienate (onself), to become alienated	v
sich verpflichten	to commit or pledge (oneself), be dedicated to	v
malen	to paint	v
prägen	to coin, form, determine the shape of	v
umstritten	controversial	adj
die Währungsunion	currency union	n
aufmerksam	attentive	adj
auf der einen Seite	on one side/hand
beschließen (beschloß, beschlossen)	to resolve, decide	v	irreg (sp, pp)
verschieben (verschob, verschoben)	to postpone	v	irreg (sp, pp)
nunmehr	henceforth, now, by this time
vollenden	to complete	v
das Selbstbewusstsein	self-confidence	n
die Baustelle	construction site	n
der Stadtführer	guide (book) to the city	n	-
die Stätte	place, abode	n	-n
die Leidenschaft	passion	n	-en
streitbar	pugnacious, disputacious	adj
mutig	brave	adj
sich infizieren	to get an infection	v
bald darauf	soon thereafter
zuvor	earlier	adv
die Preisverleihung	award	n
schallen	to resound	v
die Ohrfeige	slap in the face	n	-n
die Machthaber	dictatorial powers	n	pl
die Bestätigung	confirmation	n
vertreiben (vertrieb, vertrieben)	to exile, banish	v	irreg (sp, pp)
der Flüchtling	refugee	n
der Hilfsschreiber	assistant recorder	n	-
das Amtsgericht	district court	n
erziehen (erzog, erzogen)	to educate, train	v	irreg (sp, pp)
der Verfechter	defender	n	-
die Absicht	aim	, intention	n
durch/setzen	to push through, bring about	v
sich ein/setzen für	to support, champion	v
der Abbau	breaking down	n
die Spannung	tension	n	-en
die Abrüstung	disarmement	n
der Redakteur	editor	n	-e
die Weltbühne	world stage	n	-n
der Leitartikler	lead story writer	n	-
korrumpierbar (von)	corruptible (by)	v
streiten (stritt, gestritten)	to fight/struggle/argue	v	irreg (sp, pp)
unabhängig	independent	adj
der Feind	enemy, opponent	n	-e
inmitten	in the middle of, in the midst of	prep
der Wahn	insanity	n
sich hingeben (gab…hin, hingegeben; gibt…hin)	to resign oneself to, submit, yield	v	irreg (sp, pp; 3p)
gelten als (galt, gegolten; gilt)	to be aimed at, be dedicated to	v	irreg (sp, pp; 3p)
publizistisch	journalistic	adj
mündiger Bürger	of responsible citizens
