ausschließlich	exclusive	adj
aus/statten	to fit out, furnish	v
bieten (bat, geboten)	to offer	v	irreg (sp, pp)
das Bild	photograph, picture	n	-er
damalig	then, of that time	adv
ein/leiten	to introduce	v
ergänzen	to supplement, add to	v
erkennen (erkannte, erkannt)	to recognize, perceive	v	irreg (sp, pp)
die Erkenntnis	perception, knowledge	n	-se
die Gegenwart	present, the present time	n
gewinnen (gewann, gewonnen)	to win, gain	v	irreg (sp, pp)
gründlich	thorough	adj
der Grundsatz	principle	n	-¨e
hervorragend	outstanding	adj
das Mittel	means, aid	n	-
der Mythos	myth	n	-os/-en
oft	often	adv
rasch	rapid, fast	adj
die Schrift	work, writing	n	-en
sonst	otherwise, else	conj
statt	instead (of)	prep
übersetzen	to translate	v
unterscheiden (unterschied, unterschieden)	to distinguish	v	irreg (sp, pp)
das Verständnis	understanding	n
der Weg	way, path	n	-e
der Wert	value, worth	n	-e
die Wirklichkeit	reality	n	-en
