zwingen (zwang, gezwungen)	to force, coerce	v	irreg (sp, pp)
widerrufen (widerrief, widerrufen)	to deny, recant	v	irreg (sp, pp)
beachten	to observe	v
die Vorsichtmaßregel	precautionary measure	n	-n
unbedingt	absolute, absolutely	adj
ein/halten (hielt…ein, eingehalten; hält…ein)	to observe	v	irreg (sp, pp; 3p)
brennbar	combustible	adj
der Wasserstoff	hydrogen	n
auf/gehen (ging…auf, ist aufgegangen)	to go up	v	irreg (sp, pp)
vor/finden (fand…vor, vorgefunden)	to find	v	irreg (sp, pp)
vor/nehmen (nahm…vor, vorgenommen; nimmt…vor)	to undertake, do	v	irreg (sp, pp; 3p)
der Gehalt	content, proportion	n	-e
der Bestandteil	component, constituent, ingredient	n	-e
gefährden	to endanger	v
der Schatz	treasure	n	-¨e
aus/stellen	to exhibit	v
die Reihenfolge	order, sequence	n	-n
an/legen	to arrange, set up	v
der Beitrag	contribution, article	n	-¨e
ägyptisch	Egyptian	adj
die Vorstellung	imagination, idea	n	-en
bekannt/machen	to introduce	v
die Rosine	raisin	n	-n
die Verheerung	destruction, devastation	-en
der Jubel	jubilation, joy	n
der Lebensunterhalt	subsistence	n	-e
die Luftbrücke	air lift ("air bridge")	n
ein/schließen (schloß…ein, eingeschlossen)	to include	v	irreg (sp, pp)
die Stromversorgung	electrical current supply	n
der Einsatz	mission	n	-¨e
befördern	to haul, transport	v
die Fracht	freight	n	-en
die Schlagfertigkeit	quick wit	n
das Betttuch	bed sheet	n	-¨er
der Fallschirm	parachute	n	-e
die Süßigkeit	sweets, candy	n	-en
ab/werfen (warf…ab, abgeworfen; wirft…ab)	to throw down, drop	v	irreg (sp, pp; 3p)
der Spitzname	nickname	n	n-noun
die Verbundenheit	bond, solidarity	n
der Vorposten	outpost	n	-
die Bereitschaft	readiness, preparedness	n
