ab/schneiden (schnitt…ab, abgeschnitten)	to cut off	v	irreg (sp, pp)
die Art	kind, type, specis	n	-en
auf/halten (hielt…auf, aufgehalten; hält…auf)	to stop, check, delay	v	irreg (sp, pp; 3p)
brennen (brannte, gebrannt)	to burn	v	irreg (sp, pp)
die Droge	drug	n	-n
die Einleitung	introduction, preface	n	-en
entfernen	to remove	v
ernten	to harvest	v
fördern	to support, foster, promote	v
das Gebrauchsgut	consumer item	n	-¨er
der Himmelskörper	celestial body	n	-
das Kraftwerk	power plant	n	-e
der Kreis	circle	n	-e
die Lebensmittel	food, victuals	n	pl
der Nachweis	proof, detection, determination	n	-e
der Rohstoff	raw material	n	-e
sicher	certain, sure, safe	adj
die Truppe	troop	n	-n
umfangreich	extensive	adj
versehen (versah, versehen; versieht)	to equip, provide	v	irreg (sp, pp; 3p)
versorgen	to provide, supply	v
vollenden	to complete, end, finish	v
vollständig	complete, entire	adj
wesentlich	essential	adj
im Wesentlichen	essentially
der Zweck	purpose	n	-e
