der Regenwurm	earthworm	n	-¨er
heraus/kommen (kam…heraus, ist herausgekommen)	to come out	v	irreg (sp, pp)
ersehen aus (ersah, ersehen; ersieht)	to see from, to understand from	v	irreg (sp, pp; 3p)
verteilen	to distribute	v
das Blutkörperchen	blood corpuscle	n	-
basieren auf	to be based upon	v
das Wahlsystem	voting system	n	-e
wahlberechtigt	entitled to vote
der Wahlkampf	election campaign	n	-¨e
rechtfertigen	to justify	v
naheliegend	obvious, reasonable	adj
aus/nutzen	to utilize	v
vorliegend	under consideration	adj
das Vorurteil	prejudice	n	-e
das Luftbild	aerial photo	n	-er
länglich	long	adj
der Säulengang	colonnade	n	-¨e
die Apsis	apse	n	is/en
die Altarnische	altar niche, altar recess	n	-n
der Gottesdienst	religious service	n	-e
die Gerichtsverhandlung	court procedure, trial	n	-en
nahe/legen	to suggest	v
flächig	flat, two-dimensional	adj
sich konzentrieren auf	to concentrate on	v
der Engel	angel	n	-
wiederum	in (his/her) turn, in return
der Mönch	monk	n	-e
der Lehrsatz	theorem, doctrine	n	-¨e
vor/schreiben (schrieb…vor, vorgeschrieben)	to dictate, prescribe	v	irreg (sp, pp)
deshalb	for that reason
sich richten nach	to conform to	v
zu/nehmen (nahm…zu, zugenommen; nimmt…zu)	to increase	v
#sich verlagern von…auf	to shift from…to
der Maßstab	standard, scale	n
naturgetreu	true to nature	adj
bestimmt sein zu	to be destined to	v
versetzen	to transplant	v
eindrucksvoll	impressive	adj
fertig/stellen	to complete	v
