die Abhandlung	treatise, discussion	n	-en
achten auf	to pay attention to	v
allerdings	certainly, to be sure, of course
die Basilika	basilica	n	-a/-en
beschäftigen	to employ, occupy	v
beschäftig sein mit	to be busy with
sich beschäftigen mit	to deal with, engage in
beschließen (beschloss, beschlossen)	to decide, conclude	v	irreg (sp, pp)
der Betrachter	viewer (m)	n	-
die Betrachterin	viewer (f)	n	-nen
die Decke	ceiling	n	-n
derart	in such a way, to such an extent
die Gefahr	danger	n	-en
gestalten	to fashion, form	v
die Handlung	action, deed	n	-en
hinauf	up, upward
hin/weisen auf (wies…hin, hingewiesen)	to refer to, point to	v	irreg (sp, pp)
malen	to paint	v
die Malerei	painting	n
der Regen	rain	n
der Standpunkt	position, standpoint, perspective	n	-e
die Übung	exercise, practice	n	-en
wählen	to vote	v
die Wand	wall	n	-¨e
