der Naturforscher	scientist	n	-
was wohl	just what
der Anspruch	claim, demand	n	-¨e
das Gift	poison	n	-e
vorsichtig	cautious, careful	adj
der Kernwaffenkrieg	nuclear war	n	-e
verhältnismäßig	relatively	adv
die Erschließung	opening, development	n	-en
der Einwanderer	immigrant	n	-
die Bevölkerungszahl	total population (statistics)	n	pl.
unmittelbar	immediate, direct	adj
#wie es auch	no matter how (what is)
lieblich	lovely, sweet	adj
duften	to smell (sweet)	v
noch einmal	once more, again
sich erholen	to recover	v
#es gäbe	there would be
das Attentat	assassination	n	-e
der Schuss	shot	n	-¨e
aus/lösen	to precipitate	v
der Thronfolger	heir to the throne	n	-
der Erzherzog	archduke	n	-e
die Gemahlin	wife	n	-nen
der Verschwörer	conspirator	n	-n
die Verschwörung	conspiracy	n	-en
der Kerker	prison	n	-
verurteilen	to condemn	v
der Mord	murder	n	-e
ein/treten für (trat…ein, ist eingetreten; tritt…ein)	to side with	irreg (sp, pp; 3p)	to side with	v	irreg (sp, pp; 3p)
der Meuchelmord	assassination	n	-e
unterbleiben (unterblieb, ist unterblieben)	not to take place	v	irreg (sp, pp)
unvermeidlich	unavoidable	adj
