anders	different, otherwise	adj
aus/brechen (brach…aus, ist ausgebrochen; bricht…aus)	to break out	v	irreg (sp, pp; 3p)
der Bewohner	inhabitant (m)	n	-
die Bewohnerin	inhabitant (f)	n	-nen
die Erfahrung	experience	n	-en
erreichen	to reach, attain	v
folgendenmaßern	as follows
die Größe	size, magnitude	n	-n
die Insel	island	n	-n
der Jahrestag	anniversary	n	-e
die Kenntnis	knowledge	n	-se
der Mund	mouth	n	-¨er
noch immer	still
richtig	right, correct
der Sieger	victor	n	-
die Siegerin	victor (f)	n	-nen
das Spielzeug	toy	n	-e
die Teilnahme	participation	n
(sich) überlegen	to think (about), ponder	v
voraus/sagen	to predict	v
das Werkzeug	tool	n	-e
die Wirkung	effect, consequence	n	-en
