der Anhänger	adherent, believer (m)	n	-
die Anhängerin	adherent, believer (f)	n	-nen
an/nehmen (nahm…an, angenommen; nimmt…an)	to assume, accept	v	irreg (sp, pp; 3p)
aus/sprechen (sprach…aus, ausgesprochen; spricht…aus)	to voice, express, pronounce	v	irreg (sp, pp; 3)
behaupten	to maintain, assert, claim	v
bereits	already, as early as	adv
berufstätig	employed, working in a job	adj
ehemalig	former
die Einheit	unity, unit	n
erweitern	to expand, broaden	v
die Fähigkeit	talent, capacity, ability	n	-en
fordern	to ask, demand	v
die Forderung	demand, request	n	-en
sich fühlen	to feel	v
die Furcht	fear	n
die Geburt	birth	n	-en
das Gefühl	feeling	n	-e
gehen (ging, ist gegangen)	to go, walk	v	irreg (sp, pp)
inzwischen	meanwhile, in the meantime
das Lebewesen	living being, creature	n	-
das Selbstbewusstsein	self-assurance, self-confidence	n
stammen	to come from, stem from	v
die Tagung	convention, meeting	n	-en
teil/nehmen (nahm…teil, teilgenommen; nimmt…teil)	to take part, participate	v	irreg (sp, pp; 3p)
die Tugend	virtue	n	-en
üben	to practice	v
um…willen	for the sake of…	v
wahr	true	adj
wirklich	actual, real, true	adj
zusammen/fassen	to summarize	v
