auf/fallen (fiel…auf, ist aufgefallen; fällt…auf)	to attract attention, be noticeable, be striking	v	irreg (sp, pp; 3p)
auf/richten	to set up, erect	v
beachten	to pay attention to
die Beziehung	relation, connection	n	-en
einzeln	individual, isolated	adj
entwerfen (entwarf, entworfen; entwirft)	to design, make a plan	v	irreg (sp, pp; 3p)
ergänzen	to complete	v
etwa	approximately	adv
der Fachmann	expert, specialst (m)	n
die Fachfrau	expert, specialst (f)	n
die Fachleute	experts, specialists	n	pl.
die Flut	flood	n	-en
gegenüber	as compared to	prep
die Gruppe	group	n	-n
das Haupt	head, chief	n	-¨er
hell	bright	adj
das Interesse	interest	n	-n
klar	clear	adj
loben	to praise	v
malen	to paint	v
der Maler	painter (m)	n
die Malerin	painter (f)	n	-nen
nämlich	namely, that is
ständig	constant	adj
das Thema	topic, theme	n	-a/-en
die Verfügung	disposal, order	n	-en
zur Verfügung stehen (stand, gestanden)	to be available	v	irreg (sp, pp)
der Verlag	publisher	n	-e
das Zeitalter	age, era	n	-
