der Eroberungszug	war of conquest	n	-¨e
trotz	in spite of
die Betrachtung	reflection, observation	n	-en
nach/gehen (ging…nach, ist nachgegangen)	to pursue	v	irreg (sp, pp)
der Aufstieg	ascent	n	-e
der Wasserstoffballon	hydrogen balloon	n	-s
der Laie	novice, layman	n	n-noun
die Feachleute	experts	n	pl
übersehen (übersah, übersehen; übersieht)	to overlook	v	irreg (sp, pp; 3p)
der Jammer	misery	n
zerreißen (zerriss, zerrissen)	to break, tear up	v	irreg (sp, pp)
die Impfung	vaccination	n	-en
an/stecken	to infect	v
die Pocken	smallpox	n	pl
die Mischinfektion	mixed (compound) infection	n	-en
der Außenminister	minister of foreign affairs	n	-
angenehm	pleasant	adj
nützlich	practical, useful	adj
die Urkunde	document	n	-n
errechnen	to calculate	v
slawisch	Slavic	adj
die Siedlung	settlement	n	-en
her/leiten	to derive	v
zusammen/wachsen (wuchs…zusammen, ist zusammengewachsen; wächst…zusammen)	to grow together, merge	v	irreg(sp, pp; 3p)
das Wappentier	emblem on a coat of arms	n	-e
die Sage	legend, fable, saga	n	-n
glauben machen	to make one believe
die Höhle	cave	n	-n
die Sachbezeichnung	designating term	n
ab/leiten	to derive	v
aus Steinen gemauert	built of stone
das Wappen	coat of arms	n	-
gebräuchlich	common, customary	adj
das Siegel	seal	n	-
locker	loose	adj
der Adler	eagle	n	-
landesherrlich	sovereign	adj
die Kralle	talon, claw	n	-n
reiten (ritt, ist geritten)	to ride, (on the back of an animal)	v
die Unterwerfung	submission	n	-en
kurfürstlich	electoral	adj
die Gewalt	power, domination, might	n
erhalten (erhielt, erhalten; erhält)	to receive	v	irreg (sp, pp; 3p)
aufrecht/stehen (stand…aufrecht; aufrechtgestanden)	to stand erect
das Blatt	leaf	n	-¨er
nahe/legen	to suggest	v
schwäbisch	Swabian	adj
anlässlich	on the occasion of

