einheimisch	indigenous	adj
#nichtdazugehörig	not belonging (to)
bestimmend	decisve
die Auswahl	selection	n
der Eingang	entry, acceptance	n	-¨e
hiesig	local	adj
die Aufnahme	inclusion	n
die Bedingung	condition	n	-en
innerhalb	within, in the boundaries of
sich auf/halten (hielt…auf, aufgehalten; hält…auf)	to spend time	v	irreg (sp, pp; 3p)
helvetisch	Swiss	adj
die Aufenthaltsbewilligung	residency permission	n	-en
das Fleckchen	speck, spot	n
fremdartig	unusual, strange	adj
die Sehnsucht	longing	n
der Abgang	departure	n	-¨e
überhaupt	altogether, anyway	adv
eruieren	to determine	v
#fündig werden	to get lucky, hit paydirt
unbestritten	indisputedly	adv
das Vexierbild	picture puzzle	n
auf/scheinen	to appear, become evident	v
dennoch	still, nevertheless	conj
wahr/nemen (nahm…wahr, wahrgenommen; nimmt…wahr)	to perceive	v	irreg (sp, pp; 3p)
mittels	by means of
abartig	abnormal	adj
gestehen (gestand, gestanden)	to admit	v	irreg (sp, pp)
nämlich	namely, that is (to say)
unabhängig	independent	adj
das Mitglied	member	n	-er
der Wechsel	change, change over	n	-
die Freizügigkeit	freedom of movement	n
eigennützig	selfish	adj
