befehlen (befahl, befohlen; befiehlt)	to order	v	irreg (sp, pp; 3p)
brechen (brach, gebrochen; bricht)	to break	v	irreg (sp, pp; 3p)
empfehlen (empfahl, empfohlen; empfiehlt)	to recommend	v	irreg (sp, pp; 3p)
#erschrecken (erschrak; erschreckt)	to frighten	v	irreg (sp, pp; 3p)
#essen (aß, gegessen; isst)	to eat	v	irreg (sp, pp; 3p)
fressen (fraß; frisst)	to devour	v	irreg (sp; 3p)
#geben (gab; gibt)	to give	v	irreg (sp; 3p)
geschehen (geschah, geschehen; geschieht)	to happen, occur, take place	v	irreg (sp, pp; 3p)
helfen (half, geholfen; hilft)	to help	v	irreg (sp, pp; 3p)
lesen (las; liest)	to read	v	irreg (sp; 3p)
messen (maß; misst)	to measure	v	irreg (sp; 3p)
#sehen (sah; sieht)	to see	v	irreg (sp; 3p)
#sprechen (sprach, gesprochen; spricht)	to speak	v	irreg (sp, pp; 3p)
stehlen (stahl, gestohlen; stiehlt)	to steal	v	irreg (sp, pp; 3p)
sterben (starb, gestorben; stirbt)	to die	v	irreg (sp, pp; 3p)
tragen (trug; trägt)	to carry, bear	v	irreg (sp; 3p)
treffen (traf, getroffen; trifft)	to meet, hit	v	irreg (sp, pp; 3p)
treten (trat; tritt)	to tread, step	v	irreg (sp; 3p)
verbergen (verbarg, verborgen; verbirgt)	to hide	v	irreg (sp, pp; 3p)
vergessen (vergaß, vergessen; vergisst)	to forget	v	irreg (sp, pp; 3p)
werden (wurde [ward], geworden; wird)	to become	v	irreg (sp [sp archaic], pp; 3p)
#werfen (warf, geworfen; wirft)	to throw	v	irreg (sp, pp; 3p)
backen (buk [backte]; bäckt)	to bake	v	irreg (sp [sp alt]; 3p)
empfangen (empfing; empfängt)	to receive	v	irreg (sp; 3p)
#fallen (fiel; fallt)	to fall	v	irreg (sp; 3p)
fahren (fuhr; fährt)	to drive, ride	v	irreg (sp; 3p)
fangen (fing; fängt)	to catch	v	irreg (sp; 3p)
halten (hielt; hält)	to hold	v	irreg (sp; 3p)
laden (lud, lädt)	to load	v	irreg (sp; 3p)
lassen (ließ; lässt)	to allow, let	v	irreg (sp; 3p)
raten (riet; rät)	to advise	v	irreg (sp; 3p)
schlafen (schlief; schläft)	to sleep	v	irreg (sp; 3p)
schlagen (schlug; schlägt)	to hit	v	irreg (sp; 3p)
wachsen (wuchs; wächst)	to grow	v	irreg (sp; 3p)
waschen (wusch; wäscht)	to wash	v	irreg (sp; 3p)
laufen (lief; lauft)	to run	v	irreg (sp; 3p)
saufen (soff, gesoffen; sauft)	to drink, guzzle	v	irreg (sp, pp; 3p)
stoßen (stieß; stößt)	to push	v	irreg (sp, pp; 3p)
