der Gradmesser	indicator (of the degree)	n	-
die Stellung	position	n	-en
das Universalstimmrecht	universal right to vote	n	-e
der Abänderungsantrag	amendment	n	-¨e
offensichtlich	obviousl(ly)	adv
der Widerspruch	contradiction	n	-¨e
eigen	own	pronoun
der Fehler	mistake, error	n	-
das Versuchsergebnis	experimental result	n	-se
das Gesetz	law	n	-e
jüdisch	Jewish	adj
der Gottesdienst	religious service	n	-e
die Vorschrift	rule	n	-en
die Lebensführung	lifestyle	n	-en
die Vorlesung	lecture	n	-en
halten	to hold	v	a to ä
die Tätigkeit	activity	n	-en
die Untätigkeit	inactivity	n	-en
die Niederschlagsmenge	amount of precipitation	n	-n
der Schnee	snow	n	
der Kuckuck	cuckoo	n	-e
werfen	to throw	v	e to i
der Ei	egg	n	-er
die Pflegeeltern	foster parents	n	pl.
füttern	to feed	v
das Adoptivkind	adopted child	n	-er
die Geschwindigkeit	speed, velocity	n	-en
der Schall	sound	n	-e or -¨e
fünfmal	five times	adj
die Uhr	clock	n	-en
die Redefreiheit	freedom of speech	n	-en
die Truppe	troops	n	-n
die Hochschule	university, college	n	-n
gründen	v
das Tschechien	Czech Republic	n
zweitältest	second-oldest	adj
das Wien	Vienna	n
fast so alt	nearly as old
sich nähern	to approach	v
die Sechshundertjahrfeier	celebration commemorating six hundred years befor	n
gehört zu	belongs to
die Gesamthochschule	polytechnic university	n	-n
die Fachhochschule	advanced technical college	n	-n
die Pädagogische Akademien	teachers' colleges	n	(pl.)
das Gesicht	face, look	n	-er
von den Studierenden	of the student body
kommen	to come (came)	omm-> am
der Studienanfänger	first year student (male)	n	-
rund	around, approximately	adv
der Fünftel	one fifth	n
mehr als	more than
der Ausländer	foreigner	n	-

