also	thus, therefore	adv
ander-	other, different	prefix
der Anfang	beginning, origin	n	-¨e
aus	out of, from	prep
beschreiben	to describe	v
betragen	to amount to, come to, be	v	a to ä
bis	until	prep
der Brief	letter	n	-e
dein	yours, your (singular informal)	adj
dritt-	third	prefix
durch	through, by	prep
enthalten	to contain, include	v	a to ä
essen	to eat	v	e to i
fallen	to fall	v	a to ä
die Form	form, shape, type	n	-en
frei	free, unconnected	adj
für	for, in favor of	prep
geben	to give	v	e to i
es gibt	there is, there are	
das Hauptfach	major field (of study)	n	-¨er
heutig	present	adj
ihr	her, its, their	pronoun
Ihr	your	pronoun
kurz	short	adj
mein	my, mine	pronoun
der Mitarbeiter	co-worker (male)	n	-
die Mitarbeiterin	co-worker (female)	n	-nen
nach	after, to	prep
das Nebenfach	minor field (of study)	n	-¨er
nur	only	adv
schreiben	to write	v
sehen	to see	v	e to ie
sein	his, its (as pronoun, not verb)	pronoun
sondern	but (rather)	conj
die Sonne	sun	n	-n
der Stamm	tribe, stem	n	-¨e
die Studium	studies at university	n	-um/-en
über	over, about	prep
die Umwelt	environment	n	-
unser	our	pronoun
verändern	to change	v
das Volk	people, nation	n	-¨er
