nur dem Namen nach	in name only
das Oberhaupt	head, ruler	n	-̈er
das Königreich	kingdom	n	-e
sich bewegen um	to orbit	
dreienhalb	three and a half
das Auge	eye	n	-n
der Ketzer	heretic	n	-
der Volksaufstand	popular uprising, revolt	n	
Deutsche Demokratische Republik (DDR)	German Democratic Republic (GDR, East Germany)
kaum genug	hardly enough
ausfürlich	detailed	adj
der Bereich	report	n	-e
wissen (wusste, gewusst, weiß)	to know	v
der Bericht	report	n	-e
zeigen	to show, demonstrate	v
wichtig	important	adj
die Ausdauer	perseverance	n
hoffnungslos	hopeless	adj
unvermeidlich	unavoidable	adj
der Wille	will	n	-n
der Sieger	winner, conqueror	n	-
das Kapital	capital, funds	n	-e,-ein
der Prozess	process	n	-e
denen	those	demonst adj
der Wiederaufbau	rebuilding, reconstruction	n
unzählige	countless	adj
die Vorschrift	rule, instruction	n	-en
Behinderte	disabled individuals	n	pl.
unbegrenzt	unlimited	adj
der Ort	place	n	-en
der Roman	novel	n	-e
VEB Merhur (volkseigener Betrieb)	(GDR) state-owned factory 'Merkur'
unruhig	discontent	adj
parteitreu	true to the (communist SED) party adj
der Kollege	co-worker, colleague	n-noun	-n
die Normerhöhung	increase in production norms	n	-en
hinnehmen sollen	ought to accept, put up with
der Grünwarenhändler	green grocer	n	-
der Kartoffelbauer	potato farmer	n-noun	-n
kriegen	to get	v
das Geschenk	present, gift	n	-e
bloß nicht	the only one who doesn't (is); so why not
durfte…schieken	to be allowed to send
Vorsicht!	Be careful! Caution!
vielleicht	maybe, perhaps	adv
die Betriebsleitung	company/plant management	n
nicht sprechen will	 doesn't want to speak
wenn die	if they
die Staatsicherheit	(GDR) state police
der/die	Delegierte	delegate (the one delegated)	n	-n
nie wieder	never again
das Rad	wheel	n	-̈er
deklamieren	to declaim, recite	v
auf einmal	suddenly
hilfloß	helpless	adj
schuld	guilty	adj
heben (hob)	to raise	v
abwehrend	in defense
lächeln	to smile	v
die Waffe	weapon	n	-n
der Unterdrücker	oppressor	n	-
heiser	hoarsely	adv
gewählt	elected	adj
an der Spitze	at the front
rufen (rief)	to shout, call out	v
im Takt	(rhythmically) in time
nieder	down	adv
war verschwunden	was gone, had disappeared
hinaus	away, outside	adv
die Werkhalle	factory bulding	n	-n
verstummen	to fall silent	v
Auszug leicht geändert	slightly altered excerpt
denn	because	adv
die Zeitung	newspaper	n	-en
engen	narrow, close	adj
das Genie	genius	n	-s
die Übung	practice	n	-en
deswegen	therefore	adv
die Wohnung	apartment, housing (pl.)	n	-en
früher	earlier	adv
holen	fetch, get	v
das Rad	wheel	n	-¨er
hilflos	helpless	adj
marschieren	to march	v
die Norm	the norm	n	-en
leicht	slightly	adv
