allein	alone, only, but
der Aufstand	revolt	n
der Bauer	farmer	n-noun	-n
bestehen aus (bestand)	to consist of	v
bestimmt	certain, definite	adj
brauchen	to need, require	v
bzw. (beziehungsweise)	or, respectively
damals	at that time, in those days	adv
denken (dachte)	to think	v
denken an	to think about
eng	narrow	adj
entdecken	to discover	v
die Erklärung	explanation, declaration	n	-en
folgen	to follow	v
geben (gab; gibt)	to give	v
es gibt	there is, there are
glauben	to believe	v
immer	always, ever	adv
war schon immer	has always been	
jemand	somebody, anybody	indef pron
kaum	hardly	adv
die Kirche	church	n	-n
die Lage	position, situation	n	-n
meinen	to opine, state an opinion, to think	v
die Meinung	opinion	n	-en
menschlich	human, humane	adj
möglich	possible	adj
die Möglichkeit	possibility	n	-en
nennen (nannte)	to name	v
niemand	nobody	indef pron
die Regierung	government	n	-en
die Reich	empire, state, realm	n	-e
sowohl…wie	both…and, not only…but also, …as well as
unterstützen	to support	v
die Unterstützung	support	n	-en
die Untersuchung	investigation, examination	n	-en
verstehen (verstand)	to understand	v
das Werk	work, plant	n	-e
die Zeit	time	n	-en
