die Wirtschaftskrise	economic crisis, depression	n	-n
der Arbeitslose	unemployed person	n	-n (male or female, here male)
die Verwandte	relative	n	-n (male or female, here female)
der Bekannte	acquaintance	n	-n (male or female, here male)
ergeben (ergab, ergibt)	to yield, give, show	v	irreg (past stem, 3rd sing)
verteilen	to distribute	v
das Vermögen	wealth	n	-
die Nächstenliebe	love for one's fellow man, charity	n
der Unfall	accident	n	-¨e
der Dschungel	jungle	n	-
schwervertletzt	seriously injured	adj
der Geburtstag	birthday	n	-e
die Schrift	script, form of writing	n	-en
farblos	colorless	adj
das Gemisch	mixture	n	-e
die Welle	wave	n	-n
die Tatache	fact	n	-n
das Kupfer	copper	n
farbig	colored	adj
der Leiter	conductor	n	-
die Antike	antiquity	n
sich unterscheiden	to differ	v
wahrscheinlich	probabable	adj
die Häufigkeit	frequency	n	-en
der Redner	orator, speaker	n
das Gesicht	face	n	-er
der Bewahrer	preserver	n	-
unglaublich	unbelievable	adj
das Stadtbild	general character of a town/city	-er
der Einblick	insight	n	-e
gekennzeichnet	characterized	adj
der Abfall von	revolt against
verstandesmäsig	rational	adj
die Nüchternheit	sobriety, dullness	n
das Gefühl	feeling	n	-e
die Stimmung	mood, emotion	n	-en
die Sehnsucht	longing, desire	n	-¨e
die Wirklichkeit	reality	n
die Vergangenheit	past	n
fern	distant, far	adj
wieder	again	adv
schätzen (an)	to think highly (about), esteem	v
sich mischen	to combine, blend, be mixed together
geheimnisvoll	mysterious	adj
unergrünlich	unfathomable	adj
der Traum	dream	n	-¨e
bildende Künste	fine arts	n	pl.
unter anderem	amonst other things
die Wiederweckung	reawakening	n	-en
gesellschaftlich	social	adj
sittlich	moral, ethical	adj
die Bindung	bond, tie	n	-en
zum ersten Mal	for the first time
vor allem	above all (else)
geistreich	ingenous, gifted	adj
das Ereignis	event, occurence	n	-se
ganz	whole, all	adj
wünschen	to wish	v
die Tatsache	fact	n	-en
laut	according to	prep	+dat
der Bereich	area	n	-n
