ähnlich	similar	adj
arm	poor	adj
ausführlich	detailed	adj
außer	besides, except for	adj
beeinflussen	to influence	v
der Bereich	realm, sphere	n	-e
besuchen	to visit	v
die Blütezeit	golden age	n	-en
der Einfluss	influence	n	-¨e
einzig	only, single	adj
entwickeln	to develop	v
etwas	something, some, somewhat
finden (fand)	to find	v	strong (past)
das Flugzeug	airplane	n	-e
früh	early	adj
führen	to lead	v
führen zu	to lead to	v
geistig	intellectual, spiritual, mental	adj
gelten (galt, gilt)	to be valid, to be true, to apply	strong (past, present 3rd)
gleich	same, equal	adj
glücklich	happy, fortunate	adj
der Grieche	Greek	n	-n
die Griechin	Greek	n	-nen
die Hälfte	half	n	-n
das Interesse	interest	n	-n
der Körper	body	n	-
krank	sick, ill	adj
das Mittelalter	Middle Ages	n
die Nacht	night	n	-¨e
noch	still, even	adv
noch nicht	not yet
politisch	political	adj
der Roman	novel	n	-e
schon	already	adv
wir wissen es schon lange	we have known it for a long time
schwierig	difficult
der Stil	style	n	-e
tot	dead	adj
tragen	to carry, bear, wear	v	strong (past, present 3rd)
wesentlich	essential, important, considerable	adj
wissen	to know (facts)	v	irreg (past, present 3rd)
