das Bauhaus	Bauhaus (1919-33 German school of design)	n
die Unterrichtsstätte	pedagogical workshop	n	-n
um/siedeln	 to shift to new quarters, relocate	v
das Grundgesetz	Basic Law of the Federal Republic	n
erheben (erhob)	to elevate	v
der Staatszweck	civic goal, purpose	n	-e
konsequent	consistent, ongoing
die Klimaänderung	climatic change	n	-en
Abbau der Ozonschicht	depletion of the ozone layer
der Rückgang	decline	n	-¨e
prägen	to coin, give something a characteristic look	v
fast	nearly	adv
eigenhändig	single-handedly
#der Große Kurfürst	The Great Elector
auf/fordern	to call upon, command, invite	v
der Hofarchitekt	court architect	n-noun	
umzugestalten 	to reconfigure	v	+zu construction
das Zeughaus	military storehouse	n	-̈er
der Sinn	sense	n	-e
verschnörkelt	ornate	adj
auf/heben (hob…auf)	to suspend, repeal	v	strong (sp)
Verbot gegen die Ansiedlung von Juden	prohibition of Jewish immigration
verfolgt	prosecuted	adj
verbringen (verbrachte)	to spend	v	strong (sp)
der Lebensabend	last days of one's life	n	-e
bekannt/geben (gab…bekannt; gibt…bekannt)	to make known, make public	v	irreg (sp; 3p)
Röntgen	Wilhelm Konrad Roentgen (1845-1923, discoverer of x-ray)	
selbstgebaut	built by themselves, home-made	adj
der Doppeldecker	double decker	n
der Flug	flight	n	-̈e
zusammen/stoßen (stieß…zusammen; stößt…zusammen)	to collide	v	strong (sp; 3p)
unter/gehen (ging…unter)	to sink	v	strong (sp)
glaubwürdig	believable, worthy of believing	adj
ab/zählen	to count down	v
hinzu/fügen	to add (to)	v
schließlich	finally	adv
ein/schließen (schloss…ein)	to include	v	strong (sp)
vorliegend	present, currently under discussion	adj
eng verbunden mit	closely connected to
das Handwerk	craft, trade	n
Neue Wache	New Guardhouse
Gendarmentmarkt	(Berlin's) Gendarme Square
der Lustgarden	Pleasure Garden	n
zusammen/bringen (brachte…zusammen)	to combine, bring together	v	strong (sp)
im Wesentlichen erhalten	essentially preserved
dar/bieten (bat…dar)	to offer, present (to)	v	strong (sp)
der Entwurf	sketch, draft	n	-̈e
die Ausführung	realization (of project)	n	-en
das Diorama	diorama	n	-men
das Panorama	panorama	n	-men
die Besetzung	(military) occupation
auf/bauen	to construct, set up	v
dunkel	dark(ly)	adj, adv
beleuchtet	lighted, lit	adj
der Raum	space, room	n	-̈e
großformatig	large-format	adj
rund	round, circular	adj
das Gemälde	painting	n	-
umgeben (umgab; umgibt)	to surround	v	irreg (sp; 3p)
der Betrachter	viewer	n	-
an/schauen	to look at, view	v
die Mitte	middle, center	n
hinzu/kommen (kam…hinzu; kommt…hinzu)	to be added to	v	strong (sp; 3p)
der Standort	position	n	-e
der Rahmen	frame, border	n	-
die Kolonne	column	n	-
perspektivisch-optisch	2 vs 3-d optical	adj
die Landschaft	landscape	n	-en
der Stein	stone	n	-e
der Busch	bush	n	-̈e
usw. (und so weiter)	etc.
die Beleuchtung	lighting	n	
steigern	increase	v
aus/stellen	to exhibit	v
der Baumeister	master builder, architect	n	-
berühmtest	most famous	adv
zählen zu	to rank among	v
gemalt	painted	adj
vor/führen	to present	v
stolz	proud(ly)	adj, adv
der Schutz	protection	n	-
das Schloss	castle	n	-¨er
renovieren	renovate	v	
der Besucher	visitor (male)	n	-er
die Besucherin	visitor (female)	n	-innen
manchmal	sometimes	adv
der Zyklus	cycle	n	-en
