an/fangen (fing…an; fängt…an)	to begin	v	irreg (sp; 3p)
an/ziehen (zog…an)	to attract	v	irreg (sp)
die Aufgabe	task, problem, duty	n	-n
aus/führen	to carry out, execute	v
aus/üben	to exert	v
aus/wandern	to emigrate	v
der Bau	construction, building	n	-ten
besitzen (besaß, besessen)	to possess, have	v	(sp, pp)
der Bruder	brother	n	-̈e
daher	therefore, hence	conj
dar/stellen	to represent, depict	v
die Eigenschaft	property, quality	n	-en
einfach	simple, simply	adj, adv
die Einführung	introduction	n	-en
ein/laden (lud…ein; lädt…ein)	to invite	v	strong (sp; 3p)
ein/nehmen (nahm…ein; nimmt…ein)	to take up, occupy	v	strong (sp; 3p)
ein/teilen	to divide, classify	v
die Entdeckung	discovery	n	-en
die Erziehung	education, upbringing	n
gefährdet	endangered	adj
grün	green	adj
grundsätzlich	fundamental(ly)	adj, adv
der Grundzug	main feature, characteristic	n	-̈e
die Heimat	home	n
kaum	hardly	adv
die Kraft	power, force, strength	n	-̈e
die Reise	trip	n	-n
sofort	immediately	adv
statt/finden (fand…statt)	to take place, occur	v	strong (sp)
der Umweltschutz	environmental protection	n
um/ziehen (zog…um)	to move	v	strong (sp)
der Ursprung	origin, source	n	-̈e
ursprünglich	original(ly)	adj, adv
die Veränderung	change	n	-en
verhältnismäßig	relatively, comparatively	adv
verstehen (verstand)	to understand	v	strong (sp)
die Vielfalt	diversity, variety, multiplicity	n
die Voraussetzung	assumption, hypothesis	n	-en
vor/ziehen (zog…vor)	to prefer	v	strong (sp)
wahrscheinlich	probably	adv
weich	soft	adj
weiß	while	adj
weiter	further	adv
wesentlich	essential(ly)	adj, adv
das Wort	word	n	-e, -̈er
zurück/kehren	to return
