bei/tragen (trug…bei, beigetragen; trägt…bei)	to contribute	v	irreg (sp, pp; 3p)
berichten	to report	v
bestimmen	to ascertain, define	v
bleiben (blieb, ist geblieben)	to stay, remain	v	irreg (sp, pp)
bürgerlich	middle class, burgeois; civic	adj
deshalb	therefore
der Einwohner	inhabitant (male)	n	-
die Einwohnerin	inhabitant (female)	n	-nen
erfinden (erfand, erfunden)	to invent	v	irreg (sp, pp)
erhöhen	to increase, raise	v
ermöglichen	to make possible	v
erscheinen (erschien, ist erschienen)	to appear, to be published	v	irreg (sp, pp)
der Gegenstand	object	n	-¨e
die Gelehrte	scholar, scientist	m/f (here f)
geschehen (geschah, ist geschehen; geschieht)	to happen, take place	v	irreg (sp, pp; 3p)
das Gesetz	law	n	-e
die Gesundheit	health	n
die Grenze	boundary, border	n	-n
die Hauptstadt	capital city	n	-¨e
hören	to hear	v
kämpfen	to fight, battle	v
kennen/lernen	to get to know, become acquainted with	v
die Lehre	teaching, doctrine	n	-n
lesen (las; liest)	to read	v	(sp; 3p)
nötig	necessary, needed	adj
rein	pure, clean	adj
spät	late	adj
die Sprache	language	n	-n
sprechen (sprach, gesprochen; spricht)	to speak	v	irreg (sp, pp; 3p)
steigern	to increase, raise	v
der Teilnehmer	participant (m)	n	-
die Teilnehmerin	participant (f)	n	-nen
die Vereinigte Staaten	United States	pl
die Vernunft	reason	n
vor	in front of, before, prior, ago	prep	+dat (time/location)/acc (direction)
vor/bereiten	to prepare	v
