können (könnte, gekonnt; kann)	to be able to, can	v	irreg (sp, pp; 3p)
ungefähr	about	adv
worüber	about what
absolut	absolutely	adv
der Unfall	accident	n	-¨e
das Konto	account	n	-o/-en
gewöhnt	accustomed	adj
eigentlich	actually	adv
die Adresse	address	n	-n
der Rat	advice	n	-¨e
sich fürchten	to be afraid	v
nach	after	prep	+dat
nachmittags	in the afternoon
nachher	afterward
wieder	again
das Flugzeug	airplane	n	-e
der Flughafen	airport	n	-¨
der Luftdruck	air pressure	-¨e
alle	all
angeblich	allegedly	adv
dürfen (durfte, gedurft; darf)	to be allowed to	v	irreg (sp, pp; 3p)
fast	almost	adv
schon	already	adv
auch	also
umändern	to alter	v
immer	always	adv
der Krankenwagen	ambulance	n	-
der Amerikaner	American	n
das Tier	animal	n	-e
der Knöchel	ankle	n	-
die Antwort	answer	n	-en
antworten	to answer	v
noch etwas?	anything else?
die Vorspeise	appetizer	n	-n
der Apfel	apple	n	-¨
der Termin	appointment	n	-en
der April	April	n
der Arm	arm	n	-en
an/kommen (kam…an, ist angekommen; kommt…an)	to arrive	v	irreg (sp, pp; 3p)
sich schämen	to be ashamed	v
fragen	to ask	v
verlangen	to ask for	v
der Spargel	asparagus	n
an/nehmen (nahm…an, angenommmen; nimmt…an)	to assume	v	irreg (sp, pp; 3p)
zumindest	at least
der August	August	n
die Tante	aunt	n	-n
das Österreich	Austria	n
das Auto	automobile	n
furchtbar	awful	adj
