die Enthüllung	unveiling, disclosure, revelation	n	-en
das Bewußtsein	awareness	n
verdrängt	displaced	adj
das Elend	misery	n	-
liefern	to supply	v
einschlägigen	relevant	adj
hoffentlich	hopefully	adv
endlich	finally	adv
begrieflich	understandable	adj
die Sucht	addiction	n	-¨e
rasch	rapidly	adv
ausbreiten	to spread	v
der Zustrom	influx	n	¨e
die Sekte	the cult	n	-n
mitten	in the middle	adv
heraus entsteht (enstand, ist entstanden)	is emerging, comes forth	v	irreg (sp, pp)
jedermann	everyone
zugänglichen	accessible	adj
entspringen	to spring from, arise from, rise	v
einzigartig	unique	adj
eingeschleppte	entrained	adj
die Seuche	plague	n
